//MAP CONVERTED BY dmm2tgm.py THIS HEADER COMMENT PREVENTS RECONVERSION, DO NOT REMOVE
"ak" = (
/obj/structure/table/wood,
/obj/structure/lattice/catwalk/indoor/tatami{
	dir = 8
	},
/turf/simulated/floor/wood,
/area/exoplanet/grass/konyang)
"al" = (
/obj/effect/decal/curb/corner,
/turf/simulated/floor/exoplanet/dirt_konyang,
/area/exoplanet/grass/konyang)
"aL" = (
/obj/effect/decal/curb,
/turf/simulated/floor/exoplanet/konyang,
/area/exoplanet/grass/konyang)
"aS" = (
/obj/effect/decal/fake_object/light_source/invisible{
	light_color = "#ffffff"
	},
/turf/simulated/floor/exoplanet/dirt_konyang,
/area/exoplanet/grass/konyang)
"bk" = (
/obj/structure/table/stone/marble,
/obj/item/reagent_containers/food/condiment/sugar{
	pixel_x = 7;
	pixel_y = 8
	},
/obj/item/storage/box/produce{
	layer = 2.99;
	pixel_x = 3;
	pixel_y = -5
	},
/turf/simulated/floor/tiled/white,
/area/exoplanet/grass/konyang)
"bX" = (
/obj/structure/lattice/catwalk/indoor/tatami{
	dir = 8
	},
/obj/structure/bed/stool/chair/office/light{
	dir = 1
	},
/turf/simulated/floor/wood,
/area/exoplanet/grass/konyang)
"cP" = (
/obj/structure/flora/ausbushes/sparsegrass,
/obj/structure/flora/ausbushes/sparsegrass,
/turf/simulated/floor/exoplanet/konyang,
/area/exoplanet/grass/konyang)
"db" = (
/obj/effect/decal/curb,
/obj/structure/flora/ausbushes/sparsegrass,
/turf/simulated/floor/exoplanet/konyang,
/area/exoplanet/grass/konyang)
"dq" = (
/obj/effect/decal/fake_object/light_source/invisible{
	light_color = "#ffffff"
	},
/obj/random/dirt_75,
/turf/simulated/floor/concrete,
/area/exoplanet/grass/konyang)
"dx" = (
/obj/machinery/shower{
	pixel_y = 18
	},
/obj/random/soap,
/turf/simulated/floor/tiled/white,
/area/exoplanet/grass/konyang)
"ee" = (
/obj/effect/floor_decal/konyang_flowers,
/obj/effect/decal/fake_object/light_source/invisible{
	light_color = "#ffffff"
	},
/turf/simulated/floor/exoplanet/konyang,
/area/exoplanet/grass/konyang)
"er" = (
/obj/effect/decal/cleanable/floor_damage/wood_broken3,
/turf/simulated/floor/wood,
/area/exoplanet/grass/konyang)
"es" = (
/obj/random/dirt_75,
/obj/effect/decal/cleanable/blood/oil,
/turf/simulated/floor/concrete,
/area/exoplanet/grass/konyang)
"ev" = (
/obj/structure/bed/padded{
	pixel_y = 4
	},
/obj/structure/lattice/catwalk/indoor/tatami{
	dir = 1
	},
/obj/item/bedsheet/blue{
	pixel_y = 4
	},
/turf/simulated/floor/wood,
/area/exoplanet/grass/konyang)
"eK" = (
/turf/simulated/floor/exoplanet/konyang,
/area/exoplanet/grass/konyang)
"eS" = (
/obj/structure/flora/ausbushes/sparsegrass,
/turf/simulated/floor/exoplanet/dirt_konyang,
/area/exoplanet/grass/konyang)
"fg" = (
/obj/structure/flora/bush/konyang_reeds,
/obj/structure/flora/ausbushes/sparsegrass,
/turf/simulated/floor/exoplanet/konyang,
/area/exoplanet/grass/konyang)
"fm" = (
/obj/structure/flora/rock/konyang/small,
/turf/simulated/floor/exoplanet/konyang/wilting,
/area/exoplanet/grass/konyang)
"fw" = (
/obj/random/dirt_75,
/turf/simulated/floor/concrete,
/area/exoplanet/grass/konyang)
"fC" = (
/obj/effect/floor_decal/konyang_flowers,
/obj/structure/flora/rock/konyang/small,
/turf/simulated/floor/exoplanet/konyang,
/area/exoplanet/grass/konyang)
"fT" = (
/obj/structure/television,
/turf/simulated/floor/wood,
/area/exoplanet/grass/konyang)
"fY" = (
/obj/structure/barricade/wooden,
/obj/effect/decal/fake_object/light_source/invisible{
	light_color = "#ffffff"
	},
/turf/simulated/floor/exoplanet/dirt_konyang,
/area/exoplanet/grass/konyang)
"gx" = (
/obj/effect/decal/cleanable/blood/oil,
/obj/structure/grille/broken{
	pixel_y = 26
	},
/turf/simulated/floor/wood,
/area/exoplanet/grass/konyang)
"gN" = (
/obj/effect/floor_decal/konyang_flowers,
/turf/simulated/floor/exoplanet/konyang,
/area/exoplanet/grass/konyang)
"gT" = (
/obj/effect/decal/curb{
	dir = 8
	},
/turf/simulated/floor/exoplanet/konyang/wilting,
/area/exoplanet/grass/konyang)
"hR" = (
/obj/machinery/door/urban{
	dir = 1
	},
/obj/effect/decal/exterior_stairs/half/center,
/turf/simulated/floor/wood,
/area/exoplanet/grass/konyang)
"iB" = (
/obj/structure/bed/stool/chair/office/light,
/turf/simulated/floor/wood,
/area/exoplanet/grass/konyang)
"iI" = (
/obj/random/dirt_75,
/obj/structure/flora/rock/konyang/small,
/turf/simulated/floor/exoplanet/dirt_konyang,
/area/exoplanet/grass/konyang)
"ji" = (
/obj/item/bedsheet/orange,
/obj/structure/bed/padded,
/obj/structure/lattice/catwalk/indoor/tatami{
	dir = 8
	},
/obj/item/toy/plushie/greimorian,
/turf/simulated/floor/wood,
/area/exoplanet/grass/konyang)
"jj" = (
/obj/effect/decal/curb/corner{
	dir = 8
	},
/obj/structure/flora/bush/konyang_reeds,
/turf/simulated/floor/exoplanet/konyang,
/area/exoplanet/grass/konyang)
"jl" = (
/obj/machinery/light,
/turf/simulated/floor/wood,
/area/exoplanet/grass/konyang)
"jG" = (
/obj/structure/flora/bush/konyang_reeds,
/turf/simulated/floor/exoplanet/konyang,
/area/exoplanet/grass/konyang)
"kQ" = (
/turf/simulated/floor/wood,
/area/exoplanet/grass/konyang)
"lw" = (
/obj/structure/bed/stool/padded/brown{
	dir = 1
	},
/obj/structure/lattice/catwalk/indoor/tatami{
	dir = 8
	},
/turf/simulated/floor/wood,
/area/exoplanet/grass/konyang)
"lT" = (
/obj/structure/automobile,
/obj/random/dirt_75,
/obj/random/dirt_75,
/obj/effect/decal/cleanable/blood/oil/streak,
/turf/simulated/floor/concrete,
/area/exoplanet/grass/konyang)
"mO" = (
/obj/machinery/recharge_station,
/turf/simulated/floor/wood,
/area/exoplanet/grass/konyang)
"nx" = (
/obj/item/cell/high/empty,
/turf/simulated/floor/wood,
/area/exoplanet/grass/konyang)
"ny" = (
/obj/item/material/shard/wood,
/obj/structure/table,
/obj/machinery/light/broken,
/turf/simulated/floor/wood,
/area/exoplanet/grass/konyang)
"oA" = (
/obj/structure/flora/bush/konyang_reeds,
/turf/simulated/floor/exoplanet/konyang/wilting,
/area/exoplanet/grass/konyang)
"pi" = (
/obj/structure/lattice/catwalk/indoor/tatami{
	dir = 8
	},
/obj/structure/closet/cabinet,
/obj/item/clothing/suit/storage/hooded/wintercoat/konyang,
/obj/item/clothing/under/konyang/blue,
/obj/item/clothing/under/konyang/male/sleeveless,
/obj/item/clothing/under/konyang/male/shortsleeve,
/obj/item/clothing/under/konyangdresstraditional/blue,
/obj/item/clothing/accessory/konyang,
/obj/item/clothing/head/winterhood/konyang,
/obj/item/clothing/shoes/konyang,
/obj/item/clothing/head/konyang,
/obj/item/clothing/under/rank/konyang/police,
/obj/item/clothing/head/konyang/police,
/obj/item/clothing/under/rank/konyang/police,
/obj/item/clothing/under/rank/konyang/police,
/obj/item/toy/comic/inspector{
	pixel_y = -5
	},
/obj/item/taperoll/police,
/turf/simulated/floor/wood,
/area/exoplanet/grass/konyang)
"pw" = (
/obj/structure/flora/tree/konyang/blossom,
/obj/effect/decal/cleanable/generic/beet_tree_petals,
/turf/simulated/floor/exoplanet/konyang/pink,
/area/exoplanet/grass/konyang)
"pO" = (
/obj/item/clothing/shoes/jackboots{
	pixel_x = -3;
	pixel_y = 18
	},
/obj/item/clothing/shoes/heels{
	pixel_y = 10;
	pixel_x = 13
	},
/obj/structure/lattice/catwalk/indoor/tatami{
	dir = 8
	},
/turf/simulated/floor/wood,
/area/exoplanet/grass/konyang)
"qT" = (
/obj/structure/lattice/catwalk/indoor/tatami{
	dir = 1
	},
/turf/simulated/floor/wood,
/area/exoplanet/grass/konyang)
"qU" = (
/obj/machinery/light{
	dir = 4
	},
/turf/simulated/floor/wood,
/area/exoplanet/grass/konyang)
"sx" = (
/obj/structure/flora/bush/konyang_reeds,
/obj/structure/flora/rock/konyang/small,
/turf/simulated/floor/exoplanet/konyang,
/area/exoplanet/grass/konyang)
"sF" = (
/obj/structure/flora/bush/konyang_reeds,
/turf/simulated/floor/exoplanet/dirt_konyang,
/area/exoplanet/grass/konyang)
"sI" = (
/obj/structure/bed/stool/padded/brown{
	dir = 1
	},
/obj/structure/lattice/catwalk/indoor/tatami{
	dir = 4
	},
/turf/simulated/floor/wood,
/area/exoplanet/grass/konyang)
"th" = (
/obj/item/material/shard/wood,
/obj/machinery/light/broken{
	dir = 4
	},
/turf/simulated/floor/wood,
/area/exoplanet/grass/konyang)
"tx" = (
/obj/item/frame/apc,
/turf/simulated/floor/wood,
/area/exoplanet/grass/konyang)
"tR" = (
/obj/structure/table/wood,
/obj/structure/lattice/catwalk/indoor/tatami{
	dir = 4
	},
/turf/simulated/floor/wood,
/area/exoplanet/grass/konyang)
"tV" = (
/obj/structure/flora/rock/konyang,
/turf/simulated/floor/exoplanet/konyang,
/area/exoplanet/grass/konyang)
"uf" = (
/obj/structure/flora/rock/konyang/small,
/obj/structure/flora/bush/konyang_reeds,
/turf/simulated/floor/exoplanet/konyang,
/area/exoplanet/grass/konyang)
"um" = (
/obj/effect/floor_decal/konyang_flowers,
/obj/effect/decal/curb/corner{
	dir = 4
	},
/turf/simulated/floor/exoplanet/konyang,
/area/exoplanet/grass/konyang)
"uA" = (
/obj/structure/flora/pottedplant/bamboo,
/obj/structure/lattice/catwalk/indoor/tatami{
	dir = 1
	},
/turf/simulated/floor/wood,
/area/exoplanet/grass/konyang)
"uO" = (
/obj/machinery/light{
	dir = 1
	},
/obj/structure/table/wood,
/obj/item/gamehelm/purple,
/turf/simulated/floor/wood,
/area/exoplanet/grass/konyang)
"uW" = (
/obj/machinery/door/urban{
	dir = 1
	},
/turf/simulated/floor/wood,
/area/exoplanet/grass/konyang)
"vw" = (
/obj/structure/table/wood,
/turf/simulated/floor/wood,
/area/exoplanet/grass/konyang)
"vC" = (
/obj/machinery/door/urban{
	dir = 1
	},
/obj/effect/decal/exterior_stairs/half/center{
	dir = 1
	},
/turf/simulated/floor/wood,
/area/exoplanet/grass/konyang)
"vP" = (
/obj/effect/decal/curb{
	dir = 4
	},
/turf/simulated/floor/exoplanet/dirt_konyang,
/area/exoplanet/grass/konyang)
"vX" = (
/obj/structure/flora/pottedplant/orchid,
/turf/simulated/floor/wood,
/area/exoplanet/grass/konyang)
"wR" = (
/turf/simulated/floor/exoplanet/konyang/wilting,
/area/exoplanet/grass/konyang)
"xd" = (
/obj/structure/flora/tree/konyang/spring,
/turf/simulated/floor/exoplanet/konyang,
/area/exoplanet/grass/konyang)
"xF" = (
/turf/simulated/floor/concrete,
/area/exoplanet/grass/konyang)
"xY" = (
/obj/machinery/light,
/obj/structure/lattice/catwalk/indoor/tatami{
	dir = 4
	},
/turf/simulated/floor/wood,
/area/exoplanet/grass/konyang)
"xZ" = (
/obj/effect/decal/fake_object/light_source/invisible{
	light_color = "#ffffff"
	},
/turf/simulated/floor/exoplanet/konyang,
/area/exoplanet/grass/konyang)
"yu" = (
/obj/machinery/light,
/obj/structure/table/wood,
/turf/simulated/floor/wood,
/area/exoplanet/grass/konyang)
"yF" = (
/obj/machinery/appliance/cooker/stove,
/turf/simulated/floor/tiled/white,
/area/exoplanet/grass/konyang)
"yM" = (
/obj/machinery/light/broken{
	dir = 8
	},
/turf/simulated/floor/wood,
/area/exoplanet/grass/konyang)
"zg" = (
/obj/effect/decal/curb{
	dir = 4
	},
/obj/structure/flora/ausbushes/sparsegrass,
/turf/simulated/floor/exoplanet/konyang,
/area/exoplanet/grass/konyang)
"zr" = (
/obj/structure/barricade/wooden{
	dir = 8
	},
/obj/structure/flora/ausbushes/sparsegrass,
/turf/simulated/floor/exoplanet/konyang,
/area/exoplanet/grass/konyang)
"Ay" = (
/obj/structure/closet/crate/bin,
/turf/simulated/floor/exoplanet/konyang,
/area/exoplanet/grass/konyang)
"AH" = (
/obj/effect/decal/fake_object/light_source/invisible{
	light_color = "#ffffff"
	},
/obj/structure/flora/ausbushes/sparsegrass,
/turf/simulated/floor/exoplanet/konyang,
/area/exoplanet/grass/konyang)
"AN" = (
/obj/effect/decal/curb{
	dir = 1
	},
/obj/structure/flora/bush/konyang_reeds,
/turf/simulated/floor/exoplanet/konyang,
/area/exoplanet/grass/konyang)
"Bd" = (
/obj/machinery/light{
	dir = 8
	},
/turf/simulated/floor/tiled/white,
/area/exoplanet/grass/konyang)
"Bx" = (
/turf/template_noop,
/area/exoplanet/grass/konyang)
"CF" = (
/obj/structure/closet/cabinet,
/obj/item/clothing/suit/storage/hooded/wintercoat/konyang,
/obj/item/clothing/under/konyang,
/obj/item/clothing/under/konyang/male,
/obj/item/clothing/under/konyangdress,
/obj/item/clothing/head/winterhood/konyang,
/obj/item/clothing/shoes/konyang,
/obj/item/clothing/head/konyang,
/obj/item/haircomb,
/obj/item/clothing/head/pin/flower/pink,
/obj/item/clothing/head/pin/flower/violet,
/obj/item/clothing/head/pin/flower/yellow,
/obj/item/clothing/head/pin/flower/blue,
/obj/item/clothing/head/pin/flower,
/obj/item/toy/comic/inspector{
	pixel_y = -5
	},
/obj/item/toy/comic/inspector{
	pixel_y = -5
	},
/obj/item/toy/comic/stormman,
/obj/item/toy/comic/stormman,
/obj/item/toy/comic,
/obj/item/toy/comic,
/obj/item/toy/comic,
/obj/item/toy/comic,
/turf/simulated/floor/wood,
/area/exoplanet/grass/konyang)
"CG" = (
/obj/machinery/door/urban{
	dir = 8
	},
/turf/simulated/floor/wood,
/area/exoplanet/grass/konyang)
"Dc" = (
/obj/item/clothing/shoes/flats{
	pixel_y = 18;
	pixel_x = -3
	},
/obj/item/clothing/shoes/sneakers/black{
	pixel_x = 17;
	pixel_y = 14
	},
/obj/structure/lattice/catwalk/indoor/tatami{
	dir = 4
	},
/turf/simulated/floor/wood,
/area/exoplanet/grass/konyang)
"Df" = (
/obj/structure/table/stone/marble,
/obj/item/storage/box/snack,
/obj/item/reagent_containers/chem_disp_cartridge/tea,
/turf/simulated/floor/tiled/white,
/area/exoplanet/grass/konyang)
"EA" = (
/obj/effect/decal/cleanable/floor_damage/random_wood_broken,
/obj/item/material/shard/wood,
/obj/effect/decal/cleanable/blood/oil,
/turf/simulated/floor/wood,
/area/exoplanet/grass/konyang)
"Fn" = (
/obj/structure/barricade/wooden{
	dir = 8
	},
/turf/simulated/floor/exoplanet/konyang,
/area/exoplanet/grass/konyang)
"Fv" = (
/obj/structure/lattice/catwalk/indoor/tatami{
	dir = 4
	},
/obj/machinery/light{
	dir = 1
	},
/turf/simulated/floor/wood,
/area/exoplanet/grass/konyang)
"FZ" = (
/obj/structure/lattice/catwalk/indoor/tatami{
	dir = 1
	},
/obj/item/toy/katana,
/turf/simulated/floor/wood,
/area/exoplanet/grass/konyang)
"GN" = (
/obj/structure/closet/crate/bin/urban/dumpster,
/obj/random/junk{
	pixel_x = 1;
	pixel_y = -5
	},
/obj/random/junk{
	pixel_x = 1;
	pixel_y = -5
	},
/obj/random/junk{
	pixel_x = 1;
	pixel_y = -5
	},
/obj/random/junk{
	pixel_x = 1;
	pixel_y = -5
	},
/obj/random/junk{
	pixel_x = 1;
	pixel_y = -5
	},
/obj/random/junk{
	pixel_x = 1;
	pixel_y = -5
	},
/obj/random/loot,
/obj/random/loot,
/turf/simulated/floor/concrete,
/area/exoplanet/grass/konyang)
"HD" = (
/obj/effect/floor_decal/konyang_flowers,
/turf/simulated/floor/exoplanet/konyang/pink,
/area/exoplanet/grass/konyang)
"HW" = (
/obj/effect/map_effect/window_spawner/full/wood,
/turf/simulated/floor/tiled/full,
/area/exoplanet/grass/konyang)
"Ig" = (
/obj/random/dirt_75,
/turf/simulated/floor/exoplanet/dirt_konyang,
/area/exoplanet/grass/konyang)
"Ii" = (
/obj/machinery/light{
	dir = 1
	},
/turf/simulated/floor/wood,
/area/exoplanet/grass/konyang)
"Jc" = (
/obj/machinery/door/urban{
	dir = 8
	},
/obj/effect/decal/exterior_stairs/half/center{
	dir = 8
	},
/turf/simulated/floor/wood,
/area/exoplanet/grass/konyang)
"JJ" = (
/obj/effect/decal/cleanable/blood/oil,
/turf/simulated/floor/wood,
/area/exoplanet/grass/konyang)
"Kv" = (
/obj/effect/decal/cleanable/flour,
/turf/simulated/floor/tiled/white,
/area/exoplanet/grass/konyang)
"KF" = (
/obj/item/material/stool/chair/wood,
/obj/item/eightball/broken,
/turf/simulated/floor/wood,
/area/exoplanet/grass/konyang)
"Lc" = (
/obj/effect/floor_decal/konyang_flowers,
/turf/simulated/floor/exoplanet/konyang/wilting,
/area/exoplanet/grass/konyang)
"LR" = (
/obj/structure/lattice/catwalk/indoor/tatami{
	dir = 2
	},
/turf/simulated/floor/wood,
/area/exoplanet/grass/konyang)
"Mb" = (
/obj/effect/floor_decal/konyang_flowers,
/obj/effect/decal/curb{
	dir = 1
	},
/turf/simulated/floor/exoplanet/konyang,
/area/exoplanet/grass/konyang)
"Me" = (
/turf/simulated/floor/exoplanet/dirt_konyang,
/area/exoplanet/grass/konyang)
"My" = (
/obj/structure/toilet{
	dir = 4
	},
/obj/structure/sink{
	pixel_y = 28
	},
/turf/simulated/floor/tiled/white,
/area/exoplanet/grass/konyang)
"Ne" = (
/obj/random/dirt_75,
/obj/machinery/light,
/turf/simulated/floor/tiled/white,
/area/exoplanet/grass/konyang)
"Nn" = (
/obj/structure/closet/cabinet,
/obj/item/clothing/suit/storage/hooded/wintercoat/konyang,
/obj/item/clothing/under/konyangdresstraditional/green,
/obj/item/clothing/under/konyangdresstraditional/red,
/obj/item/clothing/under/konyang/pink,
/obj/item/clothing/under/konyangdress,
/obj/item/clothing/head/pin/magnetic,
/obj/item/clothing/head/pin/magnetic,
/obj/item/haircomb,
/turf/simulated/floor/wood,
/area/exoplanet/grass/konyang)
"Oj" = (
/obj/effect/decal/curb{
	dir = 1
	},
/obj/structure/flora/ausbushes/sparsegrass,
/turf/simulated/floor/exoplanet/konyang,
/area/exoplanet/grass/konyang)
"Ou" = (
/obj/structure/lattice/catwalk/indoor/tatami{
	dir = 4
	},
/turf/simulated/floor/wood,
/area/exoplanet/grass/konyang)
"Pc" = (
/obj/effect/decal/cleanable/flour,
/obj/item/reagent_containers/food/condiment/flour,
/turf/simulated/floor/tiled/white,
/area/exoplanet/grass/konyang)
"Pd" = (
/obj/effect/decal/curb{
	dir = 1
	},
/obj/effect/floor_decal/konyang_flowers,
/turf/simulated/floor/exoplanet/konyang,
/area/exoplanet/grass/konyang)
"PH" = (
/obj/structure/table/wood,
/obj/item/paper{
	name = "torn diary page";
	desc = "A piece of paper that looks like it was torn from a book.";
	info = [thecornerwherethedateshouldbeisruinedbyacoffeestain.]DadsaysWinnyissick.Thatvirusgoingaround.Heputherintotheshedoutfront.Itskindascary,seeingherlikethis.Dadsaidnottogettooclosetothewindows,itfreaksherout.ButIkeeptakingpeaksoutthere,justtocheckonher.Itwashardtoseeherthroughtheboards,butherscreenmadeiteasier.Shewasstandinginfrontofthewindowagain.Notmoving.Icheckedonhereverynowandthen,shewaslikethatforanhour.Idunnowhenherchargeisgonnafinallyrunout.Dadsaidhe'sgonnatakehispatrolcarandWinnyouttoamachinistsshopwhenshefinallydoeslosepower.Ihopeshe'sgoingtobeokay.Dadlovesher,soIguessIdotoo.
	},
/turf/simulated/floor/wood,
/area/exoplanet/grass/konyang)
"PL" = (
/obj/structure/flora/rock/konyang/small,
/obj/effect/decal/curb,
/turf/simulated/floor/exoplanet/konyang,
/area/exoplanet/grass/konyang)
"PR" = (
/obj/machinery/appliance/cooker/oven,
/turf/simulated/floor/tiled/white,
/area/exoplanet/grass/konyang)
"Qp" = (
/obj/structure/bed/stool/padded/brown,
/obj/structure/lattice/catwalk/indoor/tatami{
	dir = 4
	},
/turf/simulated/floor/wood,
/area/exoplanet/grass/konyang)
"Qq" = (
/obj/structure/table/stone/marble,
/obj/item/reagent_containers/cooking_container/board,
/obj/item/material/hatchet/butch,
/turf/simulated/floor/tiled/white,
/area/exoplanet/grass/konyang)
"Qv" = (
/obj/structure/flora/tree/konyang,
/turf/simulated/floor/exoplanet/konyang,
/area/exoplanet/grass/konyang)
"QI" = (
/obj/structure/flora/tree/konyang/spring,
/obj/structure/flora/ausbushes/sparsegrass,
/turf/simulated/floor/exoplanet/konyang,
/area/exoplanet/grass/konyang)
"QM" = (
/obj/machinery/door/urban,
/turf/simulated/floor/wood,
/area/exoplanet/grass/konyang)
"Rs" = (
/obj/structure/flora/bush/konyang_reeds,
/obj/effect/decal/fake_object/light_source/invisible{
	light_color = "#ffffff"
	},
/turf/simulated/floor/exoplanet/konyang/wilting,
/area/exoplanet/grass/konyang)
"Ry" = (
/obj/structure/closet/secure_closet/freezer/fridge,
/obj/item/storage/box/fancy/egg_box,
/turf/simulated/floor/tiled/white,
/area/exoplanet/grass/konyang)
"RK" = (
/obj/item/material/stool,
/turf/simulated/floor/wood,
/area/exoplanet/grass/konyang)
"SS" = (
/obj/structure/barricade/wooden{
	dir = 8
	},
/obj/effect/decal/fake_object/light_source/invisible{
	light_color = "#ffffff"
	},
/turf/simulated/floor/exoplanet/konyang,
/area/exoplanet/grass/konyang)
"To" = (
/obj/structure/flora/rock/konyang/moss,
/turf/simulated/floor/exoplanet/konyang,
/area/exoplanet/grass/konyang)
"Uo" = (
/turf/simulated/floor/tiled/white,
/area/exoplanet/grass/konyang)
"UF" = (
/obj/structure/flora/tree/konyang/spring,
/turf/simulated/floor/exoplanet/konyang/wilting,
/area/exoplanet/grass/konyang)
"UG" = (
/obj/effect/decal/cleanable/floor_damage/wood_broken1,
/turf/simulated/floor/wood,
/area/exoplanet/grass/konyang)
"UO" = (
/obj/effect/decal/fake_object/light_source/invisible{
	light_color = "#ffffff"
	},
/obj/random/dirt_75,
/turf/simulated/floor/exoplanet/dirt_konyang,
/area/exoplanet/grass/konyang)
"VH" = (
/obj/effect/decal/cleanable/floor_damage/random_wood_broken,
/obj/item/material/shard/wood,
/turf/simulated/floor/wood,
/area/exoplanet/grass/konyang)
"VO" = (
/obj/structure/flora/ausbushes/sparsegrass,
/turf/simulated/floor/exoplanet/konyang,
/area/exoplanet/grass/konyang)
"VU" = (
/obj/structure/flora/rock/konyang/small,
/turf/simulated/floor/exoplanet/konyang,
/area/exoplanet/grass/konyang)
"VW" = (
/obj/structure/table/wood,
/obj/item/toy/figure/corgi{
	pixel_y = 7;
	pixel_x = 8
	},
/obj/item/reagent_containers/glass/beaker/teapot/fluff/thea_teapot,
/obj/item/reagent_containers/food/drinks/fluff/thea_teacup,
/obj/item/reagent_containers/food/drinks/fluff/thea_teacup{
	pixel_x = -6
	},
/obj/item/reagent_containers/food/drinks/fluff/thea_teacup{
	pixel_x = 6
	},
/turf/simulated/floor/wood,
/area/exoplanet/grass/konyang)
"Wz" = (
/obj/structure/flora/bush/konyang_reeds,
/obj/effect/decal/fake_object/light_source/invisible{
	light_color = "#ffffff"
	},
/turf/simulated/floor/exoplanet/konyang,
/area/exoplanet/grass/konyang)
"WW" = (
/obj/structure/flora/rock/konyang/small,
/turf/simulated/floor/exoplanet/dirt_konyang,
/area/exoplanet/grass/konyang)
"WX" = (
/obj/effect/decal/curb{
	dir = 4
	},
/obj/effect/floor_decal/konyang_flowers,
/turf/simulated/floor/exoplanet/konyang,
/area/exoplanet/grass/konyang)
"Xf" = (
/obj/structure/flora/tree/konyang,
/turf/simulated/floor/exoplanet/konyang/wilting,
/area/exoplanet/grass/konyang)
"Xj" = (
/obj/effect/decal/cleanable/floor_damage/wood_broken6,
/obj/item/material/shard/wood,
/turf/simulated/floor/wood,
/area/exoplanet/grass/konyang)
"Yj" = (
/obj/effect/floor_decal/konyang_flowers,
/obj/structure/flora/bush/konyang_reeds,
/turf/simulated/floor/exoplanet/konyang,
/area/exoplanet/grass/konyang)
"Yy" = (
/turf/simulated/floor/exoplanet/konyang/pink,
/area/exoplanet/grass/konyang)
"YJ" = (
/obj/item/material/shard/wood,
/turf/simulated/floor/wood,
/area/exoplanet/grass/konyang)
"YW" = (
/obj/item/material/shard/wood,
/obj/structure/table,
/obj/effect/decal/cleanable/blood/oil,
/turf/simulated/floor/wood,
/area/exoplanet/grass/konyang)
"Zu" = (
/turf/simulated/wall/wood,
/area/exoplanet/grass/konyang)
"Zv" = (
/obj/effect/decal/curb{
	dir = 8
	},
/obj/structure/flora/ausbushes/sparsegrass,
/turf/simulated/floor/exoplanet/konyang,
/area/exoplanet/grass/konyang)
"ZK" = (
/obj/structure/bed/stool/padded/brown,
/obj/structure/lattice/catwalk/indoor/tatami{
	dir = 8
	},
/turf/simulated/floor/wood,
/area/exoplanet/grass/konyang)
"ZW" = (
/obj/structure/lattice/catwalk/indoor/tatami{
	dir = 8
	},
/turf/simulated/floor/wood,
/area/exoplanet/grass/konyang)

(1,1,1) = {"
Bx
Bx
Bx
Bx
To
VO
jG
jG
jG
wR
oA
fm
jG
jG
jG
gN
VU
jG
gN
jG
sx
VO
Bx
"}
(2,1,1) = {"
Bx
Bx
eK
gN
VO
jG
jG
eK
Lc
HD
HD
HD
oA
sx
jG
VO
Zu
Zu
Zu
Zu
Zu
gN
VO
"}
(3,1,1) = {"
Bx
VO
VO
eK
VO
jG
Qv
VO
wR
HD
Yy
pw
HD
oA
gN
Zu
Zu
YJ
KF
JJ
Zu
Zu
VU
"}
(4,1,1) = {"
gN
VO
eK
Qv
eK
VO
VO
gN
VO
oA
HD
HD
wR
VO
VO
Zu
yM
Xj
kQ
EA
kQ
Zu
jG
"}
(5,1,1) = {"
eK
jG
VO
VO
gN
oA
wR
eK
gN
VO
oA
oA
gN
wR
fY
hR
gx
kQ
er
kQ
ny
Zu
jG
"}
(6,1,1) = {"
jG
jG
VO
gN
oA
HD
HD
wR
xd
VO
gN
VO
eK
eS
wR
Zu
th
VH
kQ
UG
YW
Zu
jG
"}
(7,1,1) = {"
jG
gN
eK
wR
HD
pw
HD
oA
VO
jG
jG
VO
wR
Ig
cP
Zu
Zu
JJ
RK
kQ
Zu
Zu
VU
"}
(8,1,1) = {"
VO
VO
eK
Xf
HD
HD
wR
eK
jG
jG
VU
gN
wR
iI
fg
VO
Zu
HW
HW
HW
Zu
VO
VO
"}
(9,1,1) = {"
VO
To
VO
eK
wR
oA
VO
VO
gN
eK
wR
wR
Ig
wR
jG
gN
jG
Fn
SS
zr
eK
VO
gN
"}
(10,1,1) = {"
eK
xd
VO
gN
VO
eK
eK
QI
VO
sF
sF
gN
eS
wR
VO
VO
jG
VO
gN
VO
VO
QI
VO
"}
(11,1,1) = {"
VO
eK
jG
jG
eK
xd
gN
eK
VO
jG
WW
wR
wR
Me
eK
xd
VO
VO
VO
wR
oA
VO
tV
"}
(12,1,1) = {"
eK
VO
xd
jG
jG
VO
VU
jG
VO
eK
wR
wR
Me
wR
wR
VO
gN
eK
UF
HD
HD
oA
VO
"}
(13,1,1) = {"
VO
eK
eK
gN
VO
VO
eS
Ig
WW
wR
Me
Ig
Ig
Me
wR
wR
jG
eK
wR
HD
pw
HD
wR
"}
(14,1,1) = {"
gN
gN
jG
VO
wR
wR
Ig
wR
Me
eS
Ig
UO
WW
UO
eS
oA
jG
VO
gN
wR
HD
HD
wR
"}
(15,1,1) = {"
jG
jG
eK
wR
Ig
wR
wR
Me
eK
gN
Zu
Jc
Zu
Jc
Zu
Zu
Zu
VO
VO
gN
oA
oA
eK
"}
(16,1,1) = {"
jj
Zv
gT
gT
al
Me
VO
To
gN
gN
Zu
pO
kQ
ZW
Zu
My
Zu
eK
xd
eK
VO
VO
gN
"}
(17,1,1) = {"
Oj
xF
xF
fw
aL
VO
gN
VU
gN
gN
Zu
Dc
kQ
Ou
QM
Ne
Zu
gN
To
VO
eK
xd
VO
"}
(18,1,1) = {"
Mb
xF
fw
fw
db
VO
fC
ee
gN
Zu
Zu
Ii
kQ
kQ
Zu
dx
Zu
xZ
VO
VO
gN
VO
jG
"}
(19,1,1) = {"
Mb
xF
fw
xF
PL
Zu
Zu
HW
Zu
Zu
VW
kQ
kQ
kQ
Zu
Zu
Zu
HW
Zu
Zu
eK
VO
jG
"}
(20,1,1) = {"
AN
fw
lT
xF
Zu
Zu
FZ
LR
ji
Zu
fT
kQ
ZW
kQ
kQ
Zu
ZW
kQ
mO
Zu
Zu
jG
uf
"}
(21,1,1) = {"
AN
fw
es
dq
HW
uA
LR
ZW
xY
Zu
kQ
ZK
tR
lw
kQ
uW
Ou
ZW
kQ
Nn
HW
Wz
gN
"}
(22,1,1) = {"
AN
xF
fw
xF
HW
PH
bX
Ou
kQ
Zu
kQ
Qp
ak
sI
jl
Zu
pi
Ou
iB
vw
HW
jG
jG
"}
(23,1,1) = {"
Pd
fw
fw
GN
Zu
uO
Ou
kQ
kQ
uW
kQ
kQ
Ou
kQ
kQ
Zu
Fv
qT
LR
yu
Zu
jG
VO
"}
(24,1,1) = {"
Oj
fw
xF
xF
Zu
Zu
CF
kQ
kQ
Zu
kQ
qU
kQ
kQ
kQ
Zu
ev
LR
vX
Zu
Zu
jG
gN
"}
(25,1,1) = {"
um
zg
WX
vP
Me
Zu
Zu
Zu
Zu
Zu
Zu
Zu
Zu
CG
Zu
Zu
Zu
Zu
Zu
Zu
eK
VU
eK
"}
(26,1,1) = {"
Bx
jG
jG
wR
Me
Me
oA
Me
aS
hR
Uo
Bd
Uo
Uo
Df
Zu
tx
kQ
Zu
VO
gN
VO
tV
"}
(27,1,1) = {"
Bx
VO
wR
HD
HD
HD
wR
wR
Ay
Zu
Ry
Pc
Kv
Uo
bk
Zu
nx
kQ
vC
AH
jG
jG
eK
"}
(28,1,1) = {"
Bx
Bx
oA
HD
HD
pw
HD
oA
gN
Zu
Zu
Qq
yF
PR
Zu
Zu
Zu
Zu
Zu
eK
jG
jG
gN
"}
(29,1,1) = {"
Bx
Bx
eK
wR
HD
HD
HD
oA
jG
VO
Zu
HW
HW
HW
Zu
jG
jG
VO
gN
VO
jG
jG
Bx
"}
(30,1,1) = {"
Bx
Bx
Bx
gN
oA
oA
wR
VO
gN
VO
jG
jG
Rs
oA
gN
VO
VO
Yj
jG
VU
Bx
Bx
Bx
"}
